crop_and_animal_production	crop_and_animal_production_hunting_and_related_service_activities
forestry_and_logging	forestry_and_logging
fishing	fishing_and_aquaculture
mining	mining_of_coal_and_lignite
extraction_oli_ores	extraction_of_crude_petroleum_and_natural_gas_mining_of_metal_ores
other_mining	other_mining_and_quarrying
mining_support_service	mining_support_service_activities
production_of_meat_products	processing_and_preserving_of_meat_and_production_of_meat_products
fish_fruit_and_vegetables	processing_and_preserving_of_fish_crustaceans_molluscs_fruit_and_vegetables
oils_and_fats	manufacture_of_vegetable_and_animal_oils_and_fats
dairy_products	manufacture_of_dairy_products
grain_mill_products	manufacture_of_grain_mill_products_starches_and_starch_products
bakery_products	manufacture_of_bakery_and_farinaceous_products
other_food_products	manufacture_of_other_food_products
prepared_animal_feeds	manufacture_of_prepared_animal_feeds
alcohol_tobacco	manufacture_of_alcoholic_beverages_tobacco_products
soft_drinks	manufacture_of_soft_drinks_production_of_mineral_waters_and_other_bottled_waters
textiles	manufacture_of_textiles
wearing_apparel	manufacture_of_wearing_apparel
leather	manufacture_of_leather_and_related_products
wood	manufacture_of_wood_products_of_wood_cork_except_furniture_manuf_of_articles_of_straw
paper	manufacture_of_paper_and_paper_products
recorded_media	printing_and_reproduction_of_recorded_media
refined_petroleum	manufacture_of_coke_and_refined_petroleum_products
paints_varnishes_printing_ink	manufacture_of_paints_varnishes_and_similar_coatings_printing_ink_and_mastics
soap_detergents_cleaning	manufacture_of_soap_detergents_cleaning_polishing_perfumes_toilet_preparations
other_chemical	manufacture_of_other_chemical_products
industrial_gases_chemicals	manufacture_of_industrial_gases_inorganics_and_fertilisers_inorganic_chemicals_20_11_13_15
petrochemicals	manufacture_of_petrochemicals_20_14_16_17_60
dyestuffs_agro_chemicals	manufacture_of_dyestuffs_agro_chemicals_20_12_20
pharmaceutical	manufacture_of_basic_pharmaceutical_products_and_pharmaceutical_preparations
rubber_and_plastic	manufacture_of_rubber_and_plastic_products
cement_lime_plaster	manufacture_of_cement_lime_plaster_and_articles_of_concrete_cement_and_plaster
glass_clay_ceramic	manufacture_of_glass_refractory_clay_porcelain_ceramic_stone_products_23_1_4_7_9
iron_steel	manufacture_of_basic_iron_and_steel
other_metals_and_casting	manufacture_of_other_basic_metals_and_casting
weapons_ammunition	manufacture_of_weapons_and_ammunition
fabricated_metal_products	manufacture_of_fabricated_metal_products_excluding_weapons_ammunition_25_1_3_5_9
computer_electronic_optical	manufacture_of_computer_electronic_and_optical_products
electrical_equipment	manufacture_of_electrical_equipment
machinery_and_equipment	manufacture_of_machinery_and_equipment_n_e_c
motor_vehicles_trailers	manufacture_of_motor_vehicles_trailers_and_semi_trailers
building_ships	building_of_ships_and_boats
air_and_spacecraft	manufacture_of_air_and_spacecraft_and_related_machinery
other_transport_equipment	manufacture_of_other_transport_equipment_30_2_4_9
furniture	manufacture_of_furniture
other_manufacturing	other_manufacturing
maintenance_ships	repair_and_maintenance_of_ships_and_boats
maintenance_aircraft_spacecraft	repair_and_maintenance_of_aircraft_and_spacecraft
rest_of_repair_installation	rest_of_repair_installation_33_11_14_17_19_20
electric_power_generation	electric_power_generation_transmission_and_distribution
manufacture_of_gas_distribution	manufacture_of_gas_distribution_of_gaseous_fuels_through_mains_steam_and_aircon_supply
water_collection_treatment_and_supply	water_collection_treatment_and_supply
sewerage	sewerage
waste_collection_treatment	waste_collection_treatment_and_disposal_activities_materials_recovery
other_waste_management_services	remediation_activities_and_other_waste_management_services
construction	construction
motor_vehicles_and_motorcycles	wholesale_and_retail_trade_and_repair_of_motor_vehicles_and_motorcycles
wholesale_trade	wholesale_trade_except_of_motor_vehicles_and_motorcycles
retail_trade	retail_trade_except_of_motor_vehicles_and_motorcycles
rail_transport	rail_transport
land_transport_services	land_transport_services_and_transport_services_via_pipelines_excluding_rail_transport
water_transport	water_transport
air_transport	air_transport
warehousing	warehousing_and_support_activities_for_transportation
postal_and_courier	postal_and_courier_activities
accommodation	accommodation
food_and_beverage	food_and_beverage_service_activities
publishing_activities	publishing_activities
motion_picture_video	motion_picture_video_tv_programme_production_sound_recording_music_publishing_activities_programming_and_broadcasting_activities
telecommunications	telecommunications
computer_programming	computer_programming_consultancy_and_related_activities
information_service_activities	information_service_activities
financial_service_activities	financial_service_activities_except_insurance_and_pension_funding
insurance_pension	insurance_reinsurance_and_pension_funding_services_except_compulsory_social_security
auxiliary_financial_services	activities_auxiliary_to_financial_services_and_insurance_activities
real_estate_services	real_estate_services_on_a_fee_or_contract_basis
owner_occupiers_housing	owner_occupiers_housing
buying_and_selling_renting	buying_and_selling_renting_and_operating_of_own_or_leased_real_estate_excluding_imputed_rent
legal_activities	legal_activities
accounting_bookkeeping	accounting_bookkeeping_and_auditing_activities_tax_consultancy
head_offices_management	activities_of_head_offices_management_consultancy_activities
architectural	architectural_and_engineering_activities_technical_testing_and_analysis
scientific_r_and_d	scientific_research_and_development
advertising_market_research	advertising_and_market_research
other_scientific_activities	other_professional_scientific_and_technical_activities
veterinary_activities	veterinary_activities
rental_leasing_activities	rental_and_leasing_activities
employment_activities	employment_activities
travel_agency	travel_agency_tour_operator_and_other_reservation_service_and_related_activities
security_activities	security_and_investigation_activities
services_to_buildings	services_to_buildings_and_landscape_activities
administrative_office_support	office_administrative_office_support_and_other_business_support_activities
public_administration	public_administration_and_defence_compulsory_social_security
education	education
human_health_activities	human_health_activities
social_work_activities	residential_care_social_work_activities
creative_arts_activities	creative_arts_and_entertainment_activities
libraries_archives_museums	libraries_archives_museums_and_other_cultural_activities
gambling_and_betting_activities	gambling_and_betting_activities
sports_and_amusement_activities	sports_activities_and_amusement_and_recreation_activities
membership_organisations	activities_of_membership_organisations
repair_of_household_goods	repair_of_computers_and_personal_and_household_goods
other_personal_service_activities	other_personal_service_activities

